EA ./textures/path_to_the_east_texture




C 0,0,10
F 10,10,10

NO                  ./textures/path_to_the_north_texture  
WE ./textures/path_to_the_west_texture

SO ./textures/path_to_the_south_texture
111111111111111
100000000000101
100001000000101
111110000010101
100000000010101
1000000N1111101
100000000000001
100000000000001
111111000111101
100000000000001
111111111111111