EA ./textures/path_to_the_east_texture
NO ./textures/path_to_the_north_texture  
WE ./textures/path_to_the_west_texture
SO ./textures/path_to_the_south_texture

C 135,206,250
F 144,238,144


111111111111111
100000000000001
100100000000101
111000000000011
100000000000001
1000000N0000001
100000000000001
101000000000011
100100000000101
100000000000001
111111111111111