NO ./textures/path_to_the_north_texture
SO ./textures/path_to_the_south_texture
WE ./textures/path_to_the_west_texture
EA ./textures/path_to_the_east_texture



F 0,100,0222
C 225,30,0



    111111111111111111111111
1000000000110000000000001
1011000001110000000000001
1001000000000000000000001
     111111111011000001110000000000001
     100000000011000001110111111111111
     11110111111111011100000010001
     11110111111111011101010010001
     1100000011010101110000010001
10000000000000001100000010001
10000000000000001101010010 101
1100000111010101111101111 N 1111
11110111 1110101 101111000 0 1
11111111 1111111 111111111111