EA ./textures/path_to_the_east_texture




C 0,0,10
F 10,10,10

NO                  ./textures/path_to_the_north_texture  
WE ./textures/path_to_the_west_texture

SO ./textures/path_to_the_south_texture
  
                                           
1111   11111111111111111111111111111111111
11111111000000000000000000000000000000111
1000000000000000000000000000000000000001 
1001111111111111111111111111111111111001
1001000000000000000000000000000000001001
1001011111111111111111111111111111001001
1001011111111111111111111111111111001001
1001011000000001110000000000000000001001 11111111111111
1001011011111111111111111111111101001001 111111111111111
1001011011111111111111111111111101001001
1001011011000000000000000000001101001001
1001011011011111111111111111101101001001
1001011011010000000000000000101101001001
100101101101000000000000000010110100111
10010110110100111111111111001011010011
111111111111111111111111111111111111                                          
1101011011010W1001111110010010110100111111
1111011010010011111100100101101001001111111
    1001011011010010010000100100101101001001
1111011011010010010000100100101101001001111
10010110110100100100110100100101101001001
1001011011010010010110100100101101001001
1001011011011110010110111100101101001001
1001011011000000010110000000101101001001
1001011011000000010110000000101101001001
1001011011111111110111111111101101001001
1001011000000000000000000000001101001001
1001011111111111110111111111111101001001
1001011111111111110111111111111101001001
1001000000000000010110000000000001001001
1001111111111110010110111111111111001001
1000000000000010010110110000000000001001
1000000000000010010110110000000000001001
1111111111111110010110111111111111111001
1000000000000000010110000000000000000001
1000000000000000010110000000000000000001
1111111111111111111111111111111111111111
  
  
  
  
1111111111111111
1000000000000001
11111111111111111

