EA ./textures/path_to_the_east_texture
NO ./textures/path_to_the_north_texture  
WE ./textures/path_to_the_west_texture
SO ./textures/path_to_the_south_texture

F 0,150,0

C 0,0,150


11111111111111111111111111111
10000000000000000000000000001
10000100000000000000000000001
10000000000000000000000000001
10000000000000000000000000001
10100N00000000000000000000001
10000000000000000000000000001
10000000000000000000000000001
10000000000000000000000000001
10000000000000000000000000001
10000000000000000000000000001
10000000000000000000000000001
10000000000000000000000000001
10000000000000000000000000001
10000000000000000000000000001
10000000000000000000000000001
10000000000000000000000000001
10000000000000000000000000001
10000000000000000000000000001
10000000000000000000000000001
10000000000000000000000000001
10000000000000000000000000001
10000000000000000000000000001
11111111111111111111111111111