EA ./textures/pacman1.xpm
NO ./textures/pacman1.xpm
SO ./textures/pacman1.xpm
WE ./textures/pacman1.xpm

C 0,0,0
F 0,0,0

11111111111111111111111111111
10000000001100000000000000001
10110000011100000010000010001
10010000000000000000000010001
10110000011100000000000010001
10000000001100000111011110001
11110111111111011100000010001
11110111111111011101010010001
11000000110101011100000010001
10001000000000001100000010001
1000000N000000001101010010001
11000000110101011111011110001
11110111111101011111011110001
11111111111111111111111111111