EA ./textures/sonic2.xpm
NO ./textures/sonic4.xpm
SO ./textures/sonic4.xpm
WE ./textures/sonic2.xpm

F      124,252,0
C 30,144,255

11111111111111111111111111
10000000000011000000000001
10111101111011011110111101
10111101111011011110111101
10111101111011011110111101
10000000000000000000000001
10111101011111111010111101
10000000000011000010000001
11111101111011011110111111
11111101000000000010111111
11111101011100111010111111
10000000010000001000000001
11111101011111111010111111
11111101000000000010111111
11111101011111111010111111
10000000000000000000000001
10111101111111111110111101
1000110000000S000000110001
11101101000000000010110111
10000001000000000010000001
10111111111011011111111101
10000000000000000000000001
11111111111111111111111111