EA ./textures/path_to_the_east_texture
NO ./textures/path_to_the_north_texture  
WE ./textures/path_to_the_west_texture
SO ./textures/path_to_the_south_texture

F 0,150,0

C 0,0,150


111111
1000001
100N001
1000001
111111